R 720 480
NO ./images/SO.xpm
SO ./images/NO.xpm
EA ./images/EA.xpm
WE ./images/WE3.xpm
S ./images/S.xpm
F 0,255,255
C 255,255,0
     11111111111111111111111111111111111
   11111111011000000000110220001001111111
  111112000000012100001220100111111111111
 1111111110110000111000000002222121001111111
11111111100000000020000000000000001111111111
1000110000000000000100000000000001111111111
100010100000000000000000000000000111111111111
10001100000000021210020000000000010000111111
1000101210000010212100100000000000000111111111
10001100200000011000001000000200000011111111
100010100001000101100010000000000000111111111
11001111111000001111111000000N00001111111111
1111011111000000011111010000000000000001111111 111
11111111111100000000000000000000111111111111111111111111111
11111111110000000000000000000000000001111111
11111111110000000000000000000000000001111111
11111111110000000000000000000000000001111111
11111111110000000010000000000000000001111111
111111111100000000000000000000000000001111111
111111111100000000000000000000000000001111111
111111111100000000000000000000000000001111111
111111111111111111111111111111111111111111111111
111111111111111111111111111111111111111111111111
111111111111111111111111111111111111111111111111
