R 720 480
NO ./images/NO.xpm
SO ./images/SO.xpm
EA ./images/EA.xpm
WE ./images/WE.xpm
S ./images/ITEM.xpm
F 0,0,1
C 01,153,15
        1111111111111111111111111
        1000000000000000000000001
        1100000000002000000000001
        1000000000000000000000001
1111111110000000000S0000000000001
100000000000000000000000000001111
100000000000000100000000000011
10000000000000010000000000001
10000000000000000000000000001
10000000000000000000000000001
10000000000000010001010000001
11000001110101011111011110101  111
11110111111101211101111010001  101
11111111111111111111111111111  111
