R 720 480
NO ./images/SO.xpm
SO ./images/NO.xpm
EA ./images/EA.xpm
WE ./images/WE3.xpm
S ./images/S.xpm
F 0,255,255
C 255,255,0
     11111111111111111111111111111111111
   11111111011000000000110220001001111
  111112000000012100001220100111111111
 1111111110110000111000000002222121001111
11111111100000000020000000000000001111111
1000110000000000000100000000000001111111
10001010000000000000000000000S0000111111111
100011000000000212100200000000000010000111111
100010121000001021210010000000000000111111
10001100200000011000001000000200000011111
100010100001000101100010000000000000111111
11001111111000001111111000000000001111111
1111011111000000011111010000000000000001 111
1111111111100000111111111111111111111111
           10001
            101
             1