R 720 480
NO ./images/SO.xpm
SO ./images/NO.xpm
EA ./images/EA.xpm
WE ./images/WE3.xpm
S ./images/S.xpm
F 0,255,255
C 255,255,0
     11111111111111111111111111111111111
        1000000000000110200001001111
        110000000000N000100001001111111
        100000000000000002222121001111
1111111110000000000000000000001111111
10001111111111100000000000001111111
10001010000100100000000000010011
10001100000000000000000000100001
10001000000001100000001000100001
10001100000010110000010000100001
10001010000100010110001000000001
110011111110000011111111101011111
1111011111000000011111010001  101
11111111111000001111111111111  111
           10001
            101
             1