R 720 480
NO ./images/dirt_full.xpm
SO ./images/slime0.xpm
EA ./images/bog_green3.xpm
WE ./images/lair0.xpm
S ./images/cute.xpm
F 0,255,0
C 0,255,150

     11111111111111111111111111111111111
   11111111011000000000110220001001111111
  111112000000012100001220100111111111111
 1111111110110000111000000002222121001111111
11111111100000000020000000000000001111111111
111111111111111111111111111111111111111111111111
10001100000000000001000000000000011111111111
11122222222222222222222222222222222222222221111
111111111100000000000000000000000000001111111
111111111100000000000000000000000000001111111
111111111100000000000000000000000000001111111
111111111100000000000000000000000000001111111
111111111100000000000000000000000000001111111
111111111111110000000000000000000011111111111111111
111111111100000000000000000000000000001111111
111111111100000000000000000000000000001111111
100010100000000000000000000000000111111111111
10001100000000021210020000000000010000111111
1000101210000010212100100000000000000111111111
10001100200000011000001000000200000011111111
10001010000100010110001000000000000111111111
1100111111100000111111100000000000000000001111111111111111
11110111110000000111110100000000000000000000000001111111 111
111111111111000000000000000000000000000000000001111111111111111111
11122222222222222222222222222222222222222221111
1111111111000000000002002000000000000001111111111111111111
1111111111000000000000200200000000222000001111111
11111111110000000000000200200000002200001111111
111111111100000000100000200200000022200001111111
11122222222222222222222222222222222222222221111
111111111100000000000000000000000000001111111
111111111100000000000000000000000000001111111
111111111100000000000000000000000000001111111
11122222222222222222222222222222222222222221111
111222222222222222222222222222222222222222211111
1111111111111111100000000000E00000000000000000001 
11111111111111111000000000000000000000000000000001 
111111111111111110000000000000000000000000000000001 
111111111111111110000000000000000000000000000000001 
111111111111111110000000000000000000000000000000001 
11111111111111111000000000000000000000000000000001 
1111111111111111100000000000000000000000000000001 
111111111111111110000000000000000000000000000001 
11111111111111111000000000000000000000000000001 
1111111111111111100000000000000000000000000001 
111111111111111110000000000000000000000000001 
11111111111111111000000000000000000000000001 
1111111111111111100000000000000000000000001 
111111111111111110000000000000000000000001 
111111111111111111111111111111111111111111111111