R 1230 128
NO ./images/NO.xpm
SO ./images/SO.xpm
EA ./images/EA.xpm
WE ./images/WE.xpm
S ./images/ITEM.xpm
F 0,0,1
C 01,153,15

        1111111111111111111111111
        1000000000000000000000001
        1100000000002000000000001
        1000000000000000000000001
1111111110000000000S0000000000001
100000000000000000000000000001111
10000000000000010000000000001
10000000000000010000000000001
10000000000000000000000000001
10000000000000000000000000001
10000000000000010001010000001
11000001110101011111011110101
11110111 1110121 101111010001
11111111 111111 1111111111111